XXXXXXXXXXXXXXXXXXXX
X R  RX   X X     XX
XXX X XXX X XXXXX XX
X X         X X R  X
X XXX XXX X X X X XX
X     X   X   X X XX
XXXXXXXXXXX X XXX XX
X   X       X      X
X X X XXXXXXXXXXXXXX
X X         XMMMX XX
XXXXX X XXX X XXX XX
X   X X   X  MX    X
X X X X XXXXXXXXX XX
X X   X   0   X   XX
X XXX X X XXX XXX XX
X   X X X   X   X XX
XXX XXXXX XXX XXX XX
X   X             XX
X X X X XXX XXX X XX
XXXXXXXXXXXXXXXXXXXX

