XXXXXXXXXXXXXXXXXXXXXXXXXXXXXXXXXX
X                               0X
XXXXXXXXXXXXXXXX XXXXXXXXXXXXXXXXX
X RR  M MM M                     X
XXXXXXXXXXXXXXXXXXXXXXXXXXXXXXXXXX