XXXXXXXXXXXXXXXXXXXX
X R     X     X X  X
X X XXXXX XXXXX X XX
X X     X XR      XX
XXXXXXX X XXXXXXX XX
X     X X   X   X XX
XXX X X X X XXX X XX
X   X   X X       XX
XXX XXX XXXXX X X XX
X   X     0   X XMXX
X XXX XXXXXXX XXXXXX
X X        MX X    X
XXX XXX X X X X X XX
X   XM  X X XM  X  X
X XXXXXXX XXXXXXXXXX
X   M X        R   X
X X XXXXX X XXXMXXXX
X X    MX X X      X
XXX              XMX
XXXXXXXXXXXXXXXXXXXX
